TTOTTXXTTATT
CfffTff9fffT
TffT1ff8TffT
Cff2ffff7ffT
TfffffSffffT
Cff3ffff6ffD
TffT4ff5TffT
BfffTffTfffG
TTHTTTPTTETT
