T8TTTXXTTOTT
1fffTffTfffT
2fffPffTfffT
3ffffffffffT
4fffTfSTfffG
5fffCffCfffT
6fffCffCfffT
7fffTffTfffT
T9CTTCCTTCTT
